3 5 3 3 3 3 3 3 3 5 3 3 3 5 3 3
3 7 1 7 0 4 2 2 2 2 4 0 0 0 0 3
3 7 1 7 0 4 2 2 2 2 4 0 0 0 0 3
3 7 1 7 0 4 2 2 2 2 4 0 0 0 0 6
3 7 1 7 0 4 2 2 2 2 4 0 0 0 0 3
3 1 1 1 0 4 2 2 2 2 4 0 0 0 0 3
6 0 0 0 0 4 2 2 2 2 4 0 0 0 0 3
3 0 0 2 2 2 2 2 2 2 2 2 2 0 0 5
3 0 0 2 2 2 2 2 2 2 2 2 2 0 0 3
3 0 0 2 2 2 2 2 2 2 2 2 2 0 0 3
5 0 0 0 0 0 0 0 0 0 0 0 0 0 0 3
3 3 3 3 3 5 3 3 3 3 3 3 3 5 3 3